EEEEEEEEEEEEEEEEEEEEEEEEEE
EEEEEEEEEEEEEEEEEEEEEEEEEE
EEBBEEBBEEBBEEBBEEBBEEBBEE
EEBBEEBBEEBBEEBBEEBBEEBBEE
EEBBEEBBEEBBEEBBEEBBEEBBEE
EEBBEEBBEEBBEEBBEEBBEEBBEE
EEBBEEBBEEBBSSBBEEBBEEBBEE
EEBBEEBBEEBBSSBBEEBBEEBBEE
EEBBEEBBEEBBEEBBEEBBEEBBEE
EEBBEEBBEEEEEEEEEEBBEEBBEE
EEBBEEBBEEEEEEEEEEBBEEBBEE
EEEEEEEEEEBBEEBBEEEEEEEEEE
EEEEEEEEEEBBEEBBEEEEEEEEEE
BBEEBBBBEEEEEEEEEEBBBBEEBB
SSEEBBBBEEEEEEEEEEBBBBEESS
EEEEEEEEEEBBEEBBEEEEEEEEEE
EEEEEEEEEEBBBBBBEEEEEEEEEE
EEBBEEBBEEBBBBBBEEBBEEBBEE
EEBBEEBBEEBBEEBBEEBBEEBBEE
EEBBEEBBEEBBEEBBEEBBEEBBEE
EEBBEEBBEEBBEEBBEEBBEEBBEE
EEBBEEBBEEEEEEEEEEBBEEBBEE
EEBBEEBBEEEEEEEEEEBBEEBBEE
EEBBEEBBEEEBBBBEEEBBEEBBEE
EEEEEEEEEEEBHHBEEEEEEEEEEE
EEEEEEEEEEEBHHBEEEEEEEEEEE



